


11111111111111111111111111111111111
1E011100000000000000000000000000001
10111110100100000101001000000010101
1P0C0100101010100010010000000101011
11111111111111111111111111111111111





