1111111111111
1P0C000000001
1000000000001
10C00E0000001
1111111111111
