11111111111111111111111111111111111
1PC00000000000000000000000000000001
10E00000000000000000000000000000001
10000000000000000000000000000000001
11111111111111111111111111111111111
