1111111111111111111111111111111111111
1PC0000000000000000000000000000000001
10C0000000000000000000000000000000001
10C0000000000000000000000000000000001
10C0000000000000000000000000000000001
10C0000000000000000000000000000000001
10C0000000000000000000000000000000001
10C0000000000000000000000000000000001
10E0000000000000000000000000000000001
1111111111111111111111111111111111111
