1111111111111111111111111
1PCEEEEEEEEEEEEEEEEEEEEE1
10C000000000000000000EEE1
10CEEEEEEEEEEEEEEEEE0EEE1
10CEEEEEECEEE111EEEE0EEE1
10CEEEEEE0EEE1E1EEEE0EEE1
10CEEEEEE0EEE111EEEE0EEE1
10CEC0000000000000CE0EEE1
10CEEEEEE0EEEEEEEEEE0EEE1
10CEEEEEE0EEEEEEEEEE0EEE1
10CEEEEEE0EEEEEEEEEE0EEE1
10CEEEEEE000000000000EEE1
10CEEEEEEEEEEEEEEEEEEEEE1
10EEEEEEEEEEEEEEEEEEEEEE1
1111111111111111111111111
